###############
#S#"2""1""5""8""3""7""1""2""4""4""9"#
#"10"#"3"#"1""5""10"####"10""2"#
#"10""1""6""7""2""5""3""4""10"#"3""9""9"#
#"7""4""1"#####"3"#####
#"2"#"7""5""1"#"5""8""2"#"5""7""4"#
#"5"##"10""7"#"5""6""5"#"3""3""2"#
#"5""7""1""2""6"#"3""10""3""9""4"#"10"#
#"3"#"1"####"1""4"###"9"#
#"2"#"10""8""4"#"1""9""8""5""5"#"10"#
#"6"#"7"#"4"#"4"###"8"#"5"#
#"6""5""4"#"5""4""10"#"9"#"9"#"1"#
#"4""7"###"2""3"#"8"#"8"#"7"#
#"7""4""1""8""1""7""10""1""6""4""10""5"G#
###############
