###############################
#S#"4""9""6""8""6""9""6""8""2""4""4""4""6""3""7""5""5"#"9""3""1""2""2""10""3""7""5"#
#"6"############"6"##"6"#"7"#"5""9"####"8""6""1"#
#"10"#"3""5""7"#"9""4""2""10""3""5""2""2""4"#"3"#"9"#"10""10""5""2""9"#"3""10""4"#
#"6"#"2"#"2"#"4"####"7""4"#"8"###"9"##"5"##"9"###"8"#
#"6""3""8"#"9""3""9"#"8""1""1""3""7""4""8""1""10"#"2""7""2""2""5"#"8"#"5""2""5"#
###"8"#####"2"#"5"#"2"###"7""7""2""3""2"###"1"#"9"###
#"5""4""10""1""1""6""2""2""6"#"9""4""6""3""10"#"7"#"4"#"3"#"2""4""5"#"1""2""5"#
#"9"#"10""5""2"#"6"###"3"#####"1"#"5"#"9"#"10"#####"2"#
#"5"#"9"#"2""2""3""4""9""7""3""4""3""7""9""8""10"#"7""7""1""8""6"#"1""5""7"#"6"#
#"3"#"7"#"3"###"4"#"7"#"7""4"##"7"#"4"#"8"#####"9"#"6"#
#"8"#"4""9""6""5""8"#"10"#"8"#"8""1""5"#"1"#"9""4""10"#"10""3""2""5""8"#"9"#
#"3"##"8"##"10"#"9"#"1"#"8"#"6"#"10"###"7"#"3"#"6"#"9""1""7"#
#"6""8""1""10""9"#"4""1""5"#"10""3""10""3""3"#"2""6""3"#"2"#"9"#"7"#"3"#"8"#
#####"6"###"8"###"1"#####"6"#"9"#"5"#"10"###"4"#
#"9""9""9"#"7""1""4""8""9""5""9""6""6""9""1""6""3"#"4""8""4""9""8"#"3"#"2""9""2"#
#"5"#"1"#"7"#"8"#"5"#####"8"#"1"###"7"#"1"#"7"#"5"###
#"10"#"5"#"3"#"4""7""2""5""1""1""7""6""3"#"2""3""6"#"2""7""1""1""6"#"1""1""6"#
#"5"#"7"#"1"###"9"#"10"##"3"##"3"#"7"#"2"###"2"###"2"#
#"7"#"7"#"10""10""8"#"7"#"6"#"2""10""10""5""8"#"10""9""4""5""4"#"6""4""6""10""9"#
#"9"#"7"#"10"#"4"###"5"###"2""10""9"#"7"###"5""8""5"#"8"#"4"#
#"2"#"3""6""8"#"6"#"2""10""7"#"6""1""10""1""9""5""8"#"4"#"10"#"9""10""1""10""4"#
#"8"#"6"###"9"#"9"###"5""3"##"7"#"9"#"2"#"2"#"8"#"3"#"5"#
#"8""4""8""6""6"#"5"#"10""8""1"#"1""8""1""5""8""6""1""7""7"#"1"#"4""2""2"#"1"#
#####"6""9""10"#"8"#"2"#"9"#"8"#"9"#####"8"#"1"#"6"#"6"#
#"6""3""3""5""10"#"1""9""8"#"9"#"7""4""7"#"5""5""10""3""3"#"10"#"2""6""2""2""4"#
#"2"##"2""6"#####"2"#"1"#"8"#####"10"#"10"#####"7"#
#"7""6""6""8""2""4""10""10""9""6""4""1""2"#"4""2""6""7""6""6""2"#"6""4""3""5""3""4""6"#
#"3"###"8"#"8"###########"6"#"5"#####"2"#"3"#
#"10""4""5""7""8""9""1""9""5""9""7""1""4""9""9""10""6""1""3"#"3""1""9""4""5""10""7""6"G#
###############################
