#################################
#S#"3""7""9""2""7""4""8""10""8""10""6"#"3""5""8""8""6""4""2""3""9""9""6""6""2""4""7""4""9"#
#"10"#"6"###"4"#####"10"#####"1"#"4"#"4"###"3"###"3"#
#"6"#"6""8""8"#"4""1""1"#"6""6""7""6""8""6""10"#"7"#"5"#"7""8""6""1""1""4""4"#"8"#
#"8"#"10"#####"6"#"3""7""6"#"8""2""8"###"8"###"7"###"2"#"3"#
#"4"#"7"#"9""9""5""9""9""5""5""10""9""5""1"#"7""7""10""9""3"#"3"#"7""10""6""6""10""2""4"#
#"2""5""3"#"7"#"6"###############"2"###"2"#"2""9""5"#
#"1"#"8"#"2"#"4""3""7""10""4"#"3""1""1""8""10""4""4""3""6"#"2""1""2"#"4"#"6""2""5"#
#"1"###"4"#"5"#"4"#"7""6""3"####"10""8"#"1"#"9"#"9"#"4"##"8""10"#
#"8""7""10"#"7""5""1""10""10"#"2"#"4""3""7"#"5""1""10"#"4"#"10"#"7""3""8"#"3""3""1"#
###"1"#"6"#####"5"#"7"###"7"#"2"#"2"#"5"#"6"###"4"#"5"#
#"5""10""8"#"8""4""3"#"5""4""10"#"10"#"5""7""3"#"1""2""5""3""1"#"6""7""2""2""1"#"9"#
#"1"#######"7"#####"3""4"##"9"###"9"#"1"#"7"#"7"#"7"#
#"6""1""9"#"4""10""3""3""6"#"7""9""10""7""5""6""9"#"4"#"6""8""10"#"9""1""5"#"7""3""10"#
#"9"#"9"#"1""2""5"#"7"#"9"#"4"##"10""2"###"2"#"1"#"3"#"3"###"4"#
#"3"#"1""8""6"#"10""7""6""5""7"#"5"#"10""3""2"#"2""7""5""1""3"#"4""8""3"#"7""4""2"#
#"5"#######"1"#"3"#"5""8""2"###"6"###"4""4""5"###"10"#"7"#
#"7""4""7""5""4"#"8""7""1""1""10"#"3"#"3""1""5"#"9"#"9""8""5""2""10""1""1"#"9""4""10"#
#"6""10"##"7"#"2"#"4"###"7"#"5"#"10"#"9"###"9"#######"7"#
#"8""1""1""6""9""9""3"#"6""1""6"#"4"#"8"#"5"#"6""7""6"#"1"#"3""7""4""9""8""6""2"#
##"6""6"#"9"#"5"###"9"#"5"#"10""8""9"###"5"###"10"#"3""1"##"7"#
#"8""1""3""9""8""1""2""9""6""3""1"#"9""10""7"#"1""5""8"#"3""10""3""5""9"#"5""9""7""4""3"#
#"6"#"2"###"1""3""8"###"5"#"2"###"5"###"4"#"10"#######
#"3"#"1""10""3""4""4""2""9"#"8""1""8"#"5""8""2"#"5""6""2"#"9""10""9""9""8"#"1""1""9"#
#"10"###"6"###"1"#"9"#"5"#######"6"#"2"###"7"#"5"#"7"#
#"4"#"5""3""3"#"5""2""10"#"3""10""7"#"3""9""9""10""10"#"2""7""5""8""8"#"9""6""7"#"2"#
#"8"#"3"###"6"#"6"###"3""2""2"###"10"#"9"###"4"###"1"#"5"#
#"9"#"10""8""8""2""10"#"6"#"3""6""4""10""6"#"8""5""7""2""5""1""8"#"5""6""2"#"1"#"8"#
#"1"#"5"#"5"#"1"#"7"#####"5"#"2"##"2"######"7"#"10"#"9"#
#"1""3""6"#"2""7""2"#"3""5""10""5""5"#"4""9""6"#"1""5""5""9""7""10""2""1""10"#"7"#"1"#
#"3""6""3"##"10""1"#####"5"#####"3"###"2""2"##"2""8""6"#"9"#
#"6"#"5"#"8""2""2"#"1""3""10"#"3""6""5""2""4""8""7"#"9"#"10""7""6""6""9"#"3"#"2"#
#"9"#"5"#"6""1"##"9""7""7"#####"9"#"7"#"9"####"10"##"1"#"9"#
#"1"#"5""3""4""2""7""2""10""2""7""1""1""4""3"#"5""2""1""1""2""10""8""2""3""10""4""6""8""10"G#
#################################
